



NO ./textures/wall/default/NO.xpm
SO ./textures/wall/default/SO.xpm
WE ./textures/wall/default/WE.xpm

EA ./textures/wall/default/EA.xpm




F             00000000100,100,100
C 50,50,50

        1111111111111111111111111
        1000000000110000000000001
        1011000001110000001000001
        1001000000000000000000001
111111111011000001110000000000001
100000000011001001110111100111111
111101111111111110000001000N1
11110111111     1010100100011
11000000111111111100000000001
10001000000000001100000010001
10000000000000000001010010001
11000001110101011111011000001
11110111 1110101 101111010001
11110111 1110101 101111010001
11111111 1111111 111111111111
